################
#              #
#    ###########
#              #
#  # # #       #
#  #           #
#  ####        #
#     #        #
#     #        #
################
